1 1 1 1 1 1 1 1 1 1 1 1 
1 1 1 1 1 1 1 1 1 1 1 1 
1 1 0 0 0 0 0 0 0 0 1 1 
1 1 0 0 0 0 0 0 0 0 1 1 
1 1 4 4 1 1 1 1 5 5 1 1 
1 1 0 0 1 0 3 1 0 0 1 1 
1 1 0 0 1 0 0 1 0 0 1 1 
1 1 5 5 1 6 1 1 4 4 1 1 
1 1 0 0 0 0 0 0 0 0 1 1 
1 1 0 0 0 0 0 0 0 0 1 1 
1 1 1 1 1 1 1 1 1 1 1 1 
1 1 1 1 1 1 1 1 1 1 1 1 
9 6
