0 1 1 1 0 0 0 0 0 0 0 0 
1 5 0 5 1 0 0 0 0 0 0 0 
1 0 4 0 1 0 0 0 0 0 0 0 
1 0 0 0 1 0 0 0 0 0 0 0 
0 1 0 1 0 0 0 0 0 0 0 0 
0 1 0 1 0 0 1 1 1 0 0 0 
1 0 0 0 1 1 3 3 3 1 0 0 
1 0 4 0 6 6 3 3 3 1 0 0 
1 0 0 0 1 1 3 3 3 1 0 0 
0 1 1 1 0 0 1 1 1 0 0 0 
0 0 0 0 0 0 0 0 0 0 0 0 
0 0 0 0 0 0 0 0 0 0 0 0 
8 2
