1 1 1 1 1 1 1 1 0 0 0 0 
1 0 0 0 0 0 0 1 0 0 0 0 
1 4 1 6 1 1 0 1 0 0 0 0 
1 5 1 3 3 1 0 1 0 0 0 0 
1 0 1 1 1 1 0 1 0 0 0 0 
1 0 0 0 0 0 0 1 0 0 0 0 
1 1 1 1 1 1 1 1 0 0 0 0 
0 0 0 0 0 0 0 0 0 0 0 0 
0 0 0 0 0 0 0 0 0 0 0 0 
0 0 0 0 0 0 0 0 0 0 0 0 
0 0 0 0 0 0 0 0 0 0 0 0 
0 0 0 0 0 0 0 0 0 0 0 0 
5 1
