1 1 1 1 1 1 1 1 1 1 1 1 
1 0 0 0 0 1 0 0 0 0 0 1 
1 0 3 0 0 1 0 5 0 4 0 1 
1 0 0 0 0 6 0 0 0 0 0 1 
1 1 1 1 1 1 5 2 5 2 5 1 
0 0 0 0 0 1 0 0 0 0 0 1 
0 0 0 0 0 1 0 0 0 0 0 1 
0 0 0 0 0 1 0 0 4 0 0 1 
0 0 0 0 0 1 0 4 0 4 0 1 
0 0 0 0 0 1 0 0 0 0 0 1 
0 0 0 0 0 1 0 0 0 0 0 1 
0 0 0 0 0 1 1 1 1 1 1 1 
10 9
