1 1 1 1 1 1 1 1 1 1 1 0 
1 5 4 0 0 0 0 0 4 5 1 0 
1 1 1 0 0 0 0 0 1 1 1 0 
1 0 0 0 1 1 1 0 0 0 1 0 
1 0 0 0 1 3 1 0 0 0 1 0 
1 2 2 2 1 6 1 2 2 2 1 0 
1 0 0 0 0 0 0 0 0 0 1 0 
1 1 1 0 0 0 0 0 1 1 1 0 
1 5 4 0 0 0 0 0 4 5 1 0 
1 1 1 1 1 1 1 1 1 1 1 0 
0 0 0 0 0 0 0 0 0 0 0 0 
0 0 0 0 0 0 0 0 0 0 0 0 
7 5
