0 0 0 0 1 1 1 1 0 0 0 0 
0 0 0 1 0 0 0 0 1 0 0 0 
0 0 1 0 0 0 0 0 0 1 0 0 
0 1 0 0 5 2 0 5 0 0 1 0 
0 1 0 0 5 0 2 5 0 0 1 0 
0 1 0 0 0 2 0 0 0 0 1 0 
0 1 0 0 4 0 2 4 0 0 1 0 
0 0 1 0 0 4 4 0 0 1 0 0 
0 0 0 1 0 0 0 0 1 0 0 0 
0 0 0 0 1 6 6 1 0 0 0 0 
0 0 0 0 1 3 3 1 0 0 0 0 
0 0 0 0 0 1 1 0 0 0 0 0 
6 2
