1 1 1 1 1 1 1 1 1 1 1 1 
1 0 0 0 1 0 0 1 0 6 3 1 
1 0 0 0 1 0 0 1 0 0 6 1 
1 1 1 1 1 1 1 1 2 2 2 1 
1 5 0 0 1 0 5 1 0 0 0 1 
1 0 0 0 1 0 0 1 0 0 0 1 
1 2 2 2 1 2 2 1 2 2 2 1 
1 0 0 0 2 0 0 2 0 0 0 1 
1 0 4 0 1 0 0 2 0 0 0 1 
1 0 4 0 1 0 0 2 0 0 0 1 
1 0 0 0 2 0 0 2 0 0 0 1 
1 1 1 1 1 1 1 1 1 1 1 1 
10 1
