1 1 1 1 1 1 1 1 1 1 0 0 
1 0 0 0 5 5 1 3 3 1 0 0 
1 0 0 0 5 5 1 3 3 1 0 0 
1 0 0 1 4 1 1 6 6 1 0 0 
1 0 0 1 0 0 1 0 0 1 0 0 
1 0 4 1 0 0 1 4 0 1 0 0 
1 0 0 1 1 1 1 0 0 1 0 0 
1 0 0 0 4 0 0 0 0 1 0 0 
1 0 0 0 0 0 0 0 0 1 0 0 
1 1 1 1 1 1 1 1 1 1 0 0 
0 0 0 0 0 0 0 0 0 0 0 0 
0 0 0 0 0 0 0 0 0 0 0 0 
5 4
