1 1 1 1 1 0 1 1 1 1 1 0 
1 0 0 0 1 1 1 0 0 0 1 0 
1 0 4 0 1 1 1 0 4 0 1 0 
1 0 0 0 1 3 1 0 0 0 1 0 
1 1 1 2 1 6 1 2 1 1 1 0 
0 0 1 0 0 0 0 0 1 0 0 0 
0 0 1 0 0 4 0 0 1 0 0 0 
0 0 1 5 0 5 0 5 1 0 0 0 
0 0 1 1 1 1 1 1 1 0 0 0 
0 0 0 0 0 0 0 0 0 0 0 0 
0 0 0 0 0 0 0 0 0 0 0 0 
0 0 0 0 0 0 0 0 0 0 0 0 
5 5
