1 1 1 1 1 1 1 0 0 0 0 0 
1 0 5 4 0 0 1 0 0 0 0 0 
1 0 4 5 0 0 1 1 1 0 0 0 
1 0 5 4 0 0 6 3 1 0 0 0 
1 0 4 5 0 0 1 1 1 0 0 0 
1 0 5 4 0 0 1 0 0 0 0 0 
1 1 1 1 1 1 1 0 0 0 0 0 
0 0 0 0 0 0 0 0 0 0 0 0 
0 0 0 0 0 0 0 0 0 0 0 0 
0 0 0 0 0 0 0 0 0 0 0 0 
0 0 0 0 0 0 0 0 0 0 0 0 
0 0 0 0 0 0 0 0 0 0 0 0 
5 1
