1 1 1 1 1 1 1 1 1 1 1 1 
1 0 0 0 0 0 0 0 0 0 0 1 
1 0 0 2 0 0 0 0 0 2 0 1 
1 0 2 4 2 0 2 0 2 4 2 1 
1 0 0 2 0 2 4 2 0 2 0 1 
1 0 0 0 0 0 2 0 0 0 0 1 
1 1 1 1 1 1 1 1 5 5 5 1 
0 0 1 3 3 3 3 1 0 0 0 1 
0 0 1 3 3 3 3 6 0 0 0 1 
0 0 1 3 3 3 3 6 0 0 0 1 
0 0 1 3 3 3 3 1 0 0 0 1 
0 0 1 1 1 1 1 1 1 1 1 1 
5 1
