1 1 1 1 1 1 1 0 0 0 0 0 
1 1 0 0 0 1 1 0 0 0 0 0 
1 0 4 0 4 5 1 0 0 0 0 0 
1 0 0 1 0 5 1 0 0 0 0 0 
1 0 4 0 4 5 1 0 0 0 0 0 
1 1 0 0 0 5 1 0 0 0 0 0 
1 1 1 6 1 1 1 0 0 0 0 0 
0 0 1 3 1 0 0 0 0 0 0 0 
0 0 1 1 1 0 0 0 0 0 0 0 
0 0 0 0 0 0 0 0 0 0 0 0 
0 0 0 0 0 0 0 0 0 0 0 0 
0 0 0 0 0 0 0 0 0 0 0 0 
2 1
