1 1 1 1 1 1 1 1 1 1 1 1 
1 0 0 0 1 1 0 5 1 1 1 1 
1 0 1 0 0 0 2 0 1 1 1 1 
1 0 0 1 1 0 2 0 0 1 1 1 
1 0 0 0 1 4 1 1 6 0 0 1 
1 2 0 2 4 0 6 3 1 0 0 1 
1 0 2 0 1 4 1 1 1 0 0 1 
1 2 0 2 1 0 5 1 1 2 2 1 
1 0 0 0 0 0 0 2 0 0 0 1 
1 0 1 1 1 0 0 2 0 0 0 1 
1 0 0 0 0 0 0 2 0 0 0 1 
1 1 1 1 1 1 1 1 1 1 1 1 
5 5
