0 0 1 1 1 1 1 1 1 1 0 0 
0 0 1 0 0 0 0 0 0 1 0 0 
0 0 1 0 5 2 5 2 0 1 0 0 
0 0 1 0 2 5 2 5 0 1 0 0 
0 0 1 0 5 2 5 2 0 1 0 0 
1 1 1 0 2 5 2 5 0 1 1 1 
1 0 0 0 4 0 4 0 0 6 3 1 
1 0 0 0 0 4 0 4 0 6 3 1 
1 0 0 0 4 0 4 0 0 6 3 1 
1 0 0 0 0 4 0 4 0 6 3 1 
1 0 0 0 0 0 0 0 0 6 3 1 
1 1 1 1 1 1 1 1 1 1 1 1 
9 2
