1 1 1 1 1 1 1 1 1 1 1 1 
1 0 0 0 2 5 0 2 0 0 0 1 
1 0 4 0 2 0 5 2 0 0 0 1 
1 0 0 0 2 5 0 2 4 0 0 1 
1 0 0 0 2 4 5 2 0 0 0 1 
1 0 0 0 2 5 0 2 0 0 0 1 
1 0 0 0 2 0 5 2 0 0 0 1 
1 0 0 4 1 1 1 1 0 0 0 1 
1 0 0 0 0 0 4 0 0 0 0 1 
1 6 0 0 0 0 0 0 0 4 0 1 
1 3 6 0 0 0 0 0 0 0 0 1 
1 1 1 1 1 1 1 1 1 1 1 1 
10 10
