0 0 0 1 1 1 1 1 1 0 0 0 
0 0 0 1 3 0 2 0 1 0 0 0 
0 0 0 1 0 2 2 0 1 0 0 0 
1 1 1 1 0 0 2 0 1 1 1 1 
1 5 5 1 2 2 2 0 6 0 0 1 
1 5 5 1 0 0 2 0 6 0 0 1 
1 5 5 1 0 2 2 0 6 0 0 1 
1 2 2 1 1 1 1 1 1 4 0 1 
1 0 0 0 4 0 4 0 4 0 0 1 
1 0 0 0 0 4 0 4 0 0 0 1 
1 0 0 0 0 0 0 0 0 0 0 1 
1 1 1 1 1 1 1 1 1 1 1 1 
10 1
