1 1 1 1 1 1 1 1 1 1 1 1 
1 0 0 0 0 0 0 0 0 6 3 1 
1 0 4 0 0 0 4 0 0 6 3 1 
1 0 0 0 4 0 0 4 0 6 3 1 
1 0 0 4 1 2 2 2 1 1 1 1 
1 0 0 0 2 5 5 5 1 0 0 0 
1 0 4 0 2 5 4 5 1 0 0 0 
1 0 0 4 2 5 5 5 1 0 0 0 
1 0 0 0 1 1 1 1 1 0 0 0 
1 1 1 1 1 0 0 0 0 0 0 0 
0 0 0 0 0 0 0 0 0 0 0 0 
0 0 0 0 0 0 0 0 0 0 0 0 
8 1
