1 1 1 1 1 1 1 1 1 0 0 0 
1 5 5 0 0 0 5 5 1 0 0 0 
1 5 5 2 0 2 5 5 1 0 0 0 
1 0 4 0 0 0 4 0 1 0 0 0 
1 1 1 1 2 1 1 1 1 0 0 0 
1 0 4 0 0 0 4 0 1 0 0 0 
1 0 0 4 0 4 0 0 1 0 0 0 
1 0 4 0 0 0 4 0 1 0 0 0 
1 0 0 0 6 0 0 0 1 0 0 0 
1 0 0 6 3 6 0 0 1 0 0 0 
1 1 1 1 1 1 1 1 1 0 0 0 
0 0 0 0 0 0 0 0 0 0 0 0 
1 4
