1 1 1 1 1 1 1 1 1 1 0 0 
1 0 0 1 0 0 1 0 0 1 0 0 
1 0 0 5 0 0 4 0 0 1 0 0 
1 4 1 1 1 5 1 2 1 1 0 0 
1 0 0 4 0 0 2 0 0 1 0 0 
1 0 0 1 0 0 1 0 0 1 0 0 
1 5 1 1 6 1 1 1 1 1 0 0 
1 0 0 6 2 2 0 3 3 1 0 0 
1 0 0 1 0 0 2 3 3 1 0 0 
1 1 1 1 1 1 1 1 1 1 0 0 
0 0 0 0 0 0 0 0 0 0 0 0 
0 0 0 0 0 0 0 0 0 0 0 0 
1 1
