0 0 1 1 1 1 1 1 1 1 0 0 
0 1 0 0 0 0 0 0 0 0 1 0 
1 6 0 0 4 0 0 4 0 0 6 1 
1 0 1 0 4 4 4 4 0 1 0 1 
1 0 1 0 4 0 0 4 0 1 0 1 
1 0 0 1 5 5 5 5 1 0 0 1 
0 1 0 1 5 5 5 5 1 0 1 0 
0 1 0 1 6 6 6 6 1 0 1 0 
0 1 0 0 3 3 3 3 0 0 1 0 
0 0 1 1 1 1 1 1 1 1 0 0 
0 0 0 0 0 0 0 0 0 0 0 0 
0 0 0 0 0 0 0 0 0 0 0 0 
1 2
