1 1 1 1 1 1 1 1 1 1 1 1 
1 0 0 0 1 0 0 0 0 0 0 1 
1 0 5 0 0 0 2 2 2 2 0 1 
1 0 0 0 1 0 0 0 0 0 0 1 
1 1 0 1 1 4 1 1 1 2 0 1 
1 0 0 0 4 0 1 3 6 0 0 1 
1 0 2 0 1 4 1 1 1 2 0 1 
1 0 2 0 1 0 1 0 0 2 0 1 
1 0 2 0 2 0 5 0 0 2 0 1 
1 0 2 0 1 0 1 0 0 5 0 1 
1 0 0 0 1 0 1 0 0 2 0 1 
1 1 1 1 1 1 1 1 1 1 1 1 
5 5
