1 1 1 1 1 1 1 1 1 1 1 1 
1 5 5 0 0 0 0 0 0 5 5 1 
1 5 5 0 4 0 4 0 0 5 5 1 
1 0 0 2 0 4 0 4 2 0 0 1 
1 0 0 4 6 6 6 6 0 4 0 1 
1 0 4 0 6 3 3 6 4 0 0 1 
1 0 0 4 6 3 3 6 0 4 0 1 
1 0 4 0 6 6 6 6 4 0 0 1 
1 0 0 2 4 0 4 0 2 0 0 1 
1 5 5 0 0 4 0 4 0 5 5 1 
1 5 5 0 0 0 0 0 0 5 5 1 
1 1 1 1 1 1 1 1 1 1 1 1 
10 5
