0 1 1 1 1 1 1 1 1 1 1 0 
1 0 0 0 6 3 3 6 0 0 0 1 
1 0 0 4 1 6 6 1 4 0 0 1 
1 0 1 5 5 5 5 5 5 1 0 1 
1 0 1 5 5 5 5 5 5 1 0 1 
1 0 0 1 1 4 4 1 1 0 0 1 
1 0 0 0 0 0 0 0 0 0 0 1 
1 0 2 2 2 2 2 2 2 2 0 1 
1 0 0 0 0 0 0 0 0 0 0 1 
1 0 4 4 4 4 4 4 4 4 0 1 
1 0 0 0 0 0 0 0 0 0 0 1 
0 1 1 1 1 1 1 1 1 1 1 0 
8 5
