0 0 0 0 0 1 1 0 0 0 0 0 
0 0 0 1 1 3 3 1 1 0 0 0 
0 1 1 0 0 6 6 0 0 1 1 0 
1 5 5 4 0 0 0 0 4 5 5 1 
1 5 5 4 4 0 0 4 4 5 5 1 
1 5 5 4 0 0 0 0 4 5 5 1 
0 1 1 0 4 4 4 4 0 1 1 0 
0 0 0 1 1 0 0 1 1 0 0 0 
0 0 0 0 0 1 1 0 0 0 0 0 
0 0 0 0 0 0 0 0 0 0 0 0 
0 0 0 0 0 0 0 0 0 0 0 0 
0 0 0 0 0 0 0 0 0 0 0 0 
7 5
