1 1 1 1 1 1 1 1 1 1 1 1 
1 0 0 0 0 0 0 0 0 6 3 1 
1 0 0 4 0 4 0 4 0 0 6 1 
1 0 4 1 1 4 1 1 1 0 0 1 
1 0 0 1 5 5 5 5 1 4 0 1 
1 0 4 1 5 5 5 5 4 0 0 1 
1 0 0 4 5 5 5 5 1 4 0 1 
1 0 4 1 5 5 5 5 1 0 0 1 
1 0 0 1 1 1 4 1 1 4 0 1 
1 0 0 0 4 0 4 0 4 0 0 1 
1 0 0 0 0 0 0 0 0 0 0 1 
1 1 1 1 1 1 1 1 1 1 1 1 
10 1
