1 1 1 0 0 0 0 0 0 0 0 0 
1 5 5 1 1 0 0 0 0 0 0 0 
1 5 5 5 5 1 1 0 0 0 0 0 
1 5 5 5 5 5 5 1 1 0 0 0 
1 0 0 0 0 0 4 0 0 1 1 0 
1 0 0 0 0 4 4 4 0 6 3 1 
1 0 0 4 0 0 4 0 0 6 3 1 
1 4 4 4 4 0 0 0 0 1 1 0 
1 0 0 4 0 0 0 1 1 0 0 0 
1 4 0 0 0 1 1 0 0 0 0 0 
1 0 0 1 1 0 0 0 0 0 0 0 
1 1 1 0 0 0 0 0 0 0 0 0 
10 1
