0 0 0 0 0 0 0 0 0 1 1 0 
0 0 0 0 0 0 0 0 1 3 3 1 
0 0 0 0 0 0 0 0 1 3 3 1 
0 0 1 1 1 1 1 1 6 6 6 1 
0 1 0 5 0 5 0 5 0 0 0 1 
1 2 5 2 5 2 5 2 5 2 0 1 
1 5 0 5 0 5 0 5 0 0 0 1 
1 0 4 0 4 0 4 0 4 0 0 1 
1 0 0 4 0 4 0 4 0 0 0 1 
1 0 4 0 4 0 4 0 4 0 0 1 
0 1 0 0 0 0 0 0 0 0 1 0 
0 0 1 1 1 1 1 1 1 1 0 0 
10 2
