1 1 1 1 1 1 1 1 1 1 0 0 
1 0 0 0 0 5 0 0 0 1 0 0 
1 0 4 0 4 5 0 4 0 1 0 0 
1 0 0 0 0 5 0 0 0 1 0 0 
1 1 6 6 1 1 1 1 1 1 0 0 
0 1 0 0 2 0 0 0 1 0 0 0 
0 1 0 0 2 2 3 0 1 0 0 0 
0 1 0 0 2 0 0 0 1 0 0 0 
0 1 1 1 1 1 1 1 1 0 0 0 
0 0 0 0 0 0 0 0 0 0 0 0 
0 0 0 0 0 0 0 0 0 0 0 0 
0 0 0 0 0 0 0 0 0 0 0 0 
1 1
