1 1 0 0 0 0 0 0 0 0 0 0 
1 3 1 0 0 0 0 0 0 0 0 0 
1 6 1 1 0 0 0 0 0 0 0 0 
1 0 0 1 1 0 0 0 0 0 0 0 
1 0 0 0 1 1 0 0 0 0 0 0 
1 0 0 2 0 1 1 0 0 0 0 0 
1 0 4 0 4 0 1 1 0 0 0 0 
1 0 0 4 0 4 0 1 1 0 0 0 
1 0 4 0 4 0 0 5 1 1 0 0 
1 0 0 2 0 0 0 5 5 1 1 0 
1 0 0 0 0 0 0 5 5 5 1 1 
1 1 1 1 1 1 1 1 1 1 1 1 
10 1
