1 1 1 1 1 1 1 1 0 0 0 0 
1 0 0 0 0 0 0 1 0 0 0 0 
1 0 5 2 0 5 0 1 0 0 0 0 
1 2 2 2 2 2 2 1 0 0 0 0 
1 0 0 0 0 0 0 1 0 0 0 0 
1 0 0 4 4 0 0 1 0 0 0 0 
1 0 0 0 0 0 0 1 0 0 0 0 
1 1 1 6 6 1 1 1 0 0 0 0 
0 0 1 3 3 1 0 0 0 0 0 0 
0 0 1 1 1 1 0 0 0 0 0 0 
0 0 0 0 0 0 0 0 0 0 0 0 
0 0 0 0 0 0 0 0 0 0 0 0 
6 1
