1 1 1 1 1 1 1 1 0 0 0 0 
1 0 1 5 0 1 3 1 0 0 0 0 
1 0 1 0 0 1 0 1 0 0 0 0 
1 0 1 4 0 6 0 1 0 0 0 0 
1 2 4 0 0 1 1 1 0 0 0 0 
1 0 1 0 2 0 1 1 0 0 0 0 
1 0 1 0 5 0 1 1 0 0 0 0 
1 1 1 1 1 1 1 1 0 0 0 0 
0 0 0 0 0 0 0 0 0 0 0 0 
0 0 0 0 0 0 0 0 0 0 0 0 
0 0 0 0 0 0 0 0 0 0 0 0 
0 0 0 0 0 0 0 0 0 0 0 0 
6 1
