1 1 1 1 1 1 1 1 1 1 1 1 
1 0 0 0 4 5 0 0 0 0 0 1 
1 0 5 0 4 5 0 0 4 0 0 1 
1 0 0 0 4 5 0 0 0 0 0 1 
1 1 6 1 1 1 1 1 1 1 1 1 
1 0 2 0 1 0 0 0 0 0 0 0 
1 2 0 2 1 0 0 0 0 0 0 0 
1 0 2 0 1 0 0 0 0 0 0 0 
1 0 3 0 1 0 0 0 0 0 0 0 
1 1 1 1 1 0 0 0 0 0 0 0 
0 0 0 0 0 0 0 0 0 0 0 0 
0 0 0 0 0 0 0 0 0 0 0 0 
1 1
