1 1 1 1 0 0 0 0 0 0 0 0 
1 0 0 1 0 0 0 0 0 0 0 0 
1 0 0 1 0 0 0 0 0 0 0 0 
1 0 4 1 1 1 1 1 1 1 1 0 
1 0 2 5 0 0 0 0 6 3 1 0 
1 0 4 5 5 2 0 0 6 3 1 0 
1 0 2 5 0 0 0 0 6 3 1 0 
1 0 4 1 1 1 1 1 1 1 1 0 
1 0 0 1 0 0 0 0 0 0 0 0 
1 0 4 1 0 0 0 0 0 0 0 0 
1 0 0 1 0 0 0 0 0 0 0 0 
1 1 1 1 0 0 0 0 0 0 0 0 
10 1
