0 0 0 0 0 1 1 1 0 0 0 0 
0 0 0 0 0 1 0 0 1 0 0 0 
0 0 0 0 0 1 4 0 0 1 0 0 
1 1 1 1 1 1 0 4 0 5 1 0 
1 3 2 0 6 0 0 0 4 5 5 1 
1 3 2 0 6 0 0 0 4 5 5 1 
1 3 2 0 6 0 0 0 4 5 5 1 
1 1 1 1 1 1 0 0 4 5 1 0 
0 0 0 0 0 1 0 4 0 1 0 0 
0 0 0 0 0 1 4 0 1 0 0 0 
0 0 0 0 0 1 0 1 0 0 0 0 
0 0 0 0 0 1 1 0 0 0 0 0 
10 6
