0 0 0 0 0 0 0 0 0 0 0 0 
0 0 0 0 0 0 0 0 0 0 0 0 
0 0 1 1 1 1 1 1 1 1 0 0 
0 1 3 3 6 0 0 0 0 0 1 0 
0 1 3 6 0 0 4 0 0 0 1 0 
0 1 6 0 0 4 0 4 0 0 1 0 
0 0 1 1 4 0 4 0 1 1 0 0 
0 1 0 0 0 4 0 0 0 5 1 0 
0 1 0 0 0 0 0 0 5 5 1 0 
0 1 0 0 0 0 0 5 5 5 1 0 
0 0 1 1 1 1 1 1 1 1 0 0 
0 0 0 0 0 0 0 0 0 0 0 0 
8 3
