0 0 0 0 0 1 1 0 0 0 0 0 
0 0 0 0 1 3 3 1 0 0 0 0 
0 0 0 0 1 3 3 1 0 0 0 0 
0 1 1 1 6 6 6 6 1 1 1 0 
1 5 0 0 0 0 0 0 0 0 5 1 
1 0 0 0 0 4 0 4 0 0 0 1 
0 1 1 1 4 4 4 4 1 1 1 0 
0 0 0 1 0 0 0 0 1 0 0 0 
0 0 1 5 0 0 0 0 5 1 0 0 
0 1 0 0 5 1 1 5 0 0 1 0 
0 1 0 0 1 0 0 1 0 0 1 0 
0 0 1 1 0 0 0 0 1 1 0 0 
10 2
