1 1 1 1 1 1 1 1 1 1 1 0 
1 0 0 0 0 0 0 0 0 0 1 0 
1 0 0 2 2 4 2 2 0 0 1 0 
1 0 2 5 0 0 0 5 2 0 1 0 
1 0 2 0 6 6 6 0 2 0 1 0 
1 0 4 0 6 3 6 0 4 0 1 0 
1 0 2 0 6 6 6 0 2 0 1 0 
1 0 2 5 0 0 0 5 2 0 1 0 
1 0 0 2 2 4 2 2 0 0 1 0 
1 0 0 0 0 0 0 0 0 0 1 0 
1 1 1 1 1 1 1 1 1 1 1 0 
0 0 0 0 0 0 0 0 0 0 0 0 
9 5
